NO textures/wall0.xpm
SO textures/wall1.xpm
WE textures/wall2.xpm
EA textures/wall03.xpm

F 120,80,50
C 70,130,180

111111111111111111111
100000000000000000001
100000000000000000001
100011000110001100001
100011000110001100001
100000000000000000001
100000000000000000001
100011000110001100001
100011000110001100001
100000000N00000000001
100000000000000000001
100011000110001100001
100011000110001100001
100000000000000000001
100000000000000000001
111111111111111111111
