NO textures/wall0.xpm
SO textures/wall1.xpm
WE textures/wall2.xpm
EA textures/wall03.xpm

F 120,80,50
C 70,130,180

    1111111111
  11100000000111
 110000000000011
 100000000000001
1100000000000011
1000000000000001
1000000N00000001
1000000000000001
1100000000000011
 100000000000001
 110000000000011
  11100000000111
    1111111111
