    NO    		     textures/wall0.xpm                   
    SO  				 textures/wall1.xpm
    WE    textures/wall2.xpm
          		 EA textures/wall03.xpm
				 

F 62		    	,39,18
C 48 , 154 ,  	 		  80




1111111111
1111111101
1W0001101 
1000011   
111101    
   101    
   101    
   111     



