NO textures/wall0.xpm
SO textures/wall1.xpm
WE textures/wall2.xpm
EA textures/wall03.xpm

F 120,80,50
C 70,130,180

1111111111
1000000001
1000000001
1000N00001
1000000001
1111100001
    100001
    100001
    100001
    100001
    111111
