NO textures/magic_wall2.xpm
SO textures/magic_wall2.xpm
WE textures/magic_wall.xpm
EA textures/magic_wall.xpm

F 25,5,5
C 10,5,15

111111111111111111111111111111
100000000001000000000100000001
101111111101011111101101111101
100100000101000001101100000101
110101110101111101101111110101
100101000100000101000000010101
101101011111110101011111010101
101001010000010001010001000101
101111010111011111010101111101
100000010101000000010101000001
101111110101111111110101011111
101000000100000N00000101010001
101011111111111111110101010111
101010000000000000010101010001
101010111111111110010101011101
100010100000000011010001000101
111110101111111011011111111101
100000101000001000000000000101
101111101011101111111111110101
100000001010001000000000010001
111111111111111111111111111111
