NO textures/wall0.xpm
SO textures/wall1.xpm
WE textures/wall2.xpm
EA textures/wall03.xpm

F 120,80,50
C 70,130,180

1111111111111111111111
1000001000000100000001
1000001000000100000001
1000001000000100000001
1000001000N00100000001
1000001000000100000001
1111011111011111101111
1000000001000000100001
1000000001000000100001
1000000001000000100001
1111111111111111111111
