NO textures/wall0.xpm
SO textures/wall1.xpm
WE textures/wall2.xpm
EA textures/wall03.xpm

F 120,80,50
C 70,130,180

111111111111111111111111
100010000000100000000001
101010111110101111111101
101010100010100000000101
101010101010111111110101
1N1000101010000000010101
101111101011111111010101
100000001000000001010101
101111111111111101010101
100000000000000001010001
111111111111111111011101
100000000000000000010001
101111111111111111110111
100000000000000000000001
111111111111111111111111
