NO textures/spells_wall.xpm
SO textures/spells_wall.xpm
WE textures/spells_wall.xpm
EA textures/spells_wall.xpm

F 20,10,30
C 5,5,20

1111111111111
1000000000001
1011101110101
1010001000101
1010111010101
1010N01010101
1011101010101
1000001010001
1111101011101
1000001000001
1111111111111
