NO textures/wall0.xpm
SO textures/wall1.xpm
WE textures/wall2.xpm
EA textures/wall03.xpm

F 120,80,50
C 70,130,180

1111111111111111
1000000000000001
1011111111111101
1010000000000101
1010111111110101
1010100000010101
1010101111010101
1010101N01010101
1010101001010101
1010100000010101
1010111111110101
1010000000000101
1011111111111101
1000000000000001
1111111111111111
