NO textures/wall0.xpm
SO textures/wall1.xpm
WE textures/wall2.xpm
EA textures/wall03.xpm

F 120,80,50
C 70,130,180

11111111111111111111
1N000111111111111111
10000000000111111111
11111111100111111111
11111111100000000011
11111111111111111011
10000000000000000011
10111111111111111111
10000000000000000011
11111111111111110011
11111111111111110001
11111111111111110001
10000000000000000001
10111111111111111111
10000000000000000001
11111111111111111111
